1111111111111
1E010000000C1
1000011111001
10P01100E0000
1111111111111